NO          ../textures/collect.xpm
SO          ../exit.xpm
WE          ../space.xpm
EA          ../wall.xpm

C       225,215,12
F       190,80,0


            1111111111111111111111111
            1000000000110000000000001
            1011000001110000000000001
           11001000000000000000000001
111111111110000011100000000000011111
100000000011000001110111111111111
11110111111111011100000010001
11110111111111011101010010001
11000000110101011100000010001
10000000000000001100000010001
10000000000000001101010010001
11000001110101011111011110W0111
11110111 11101011101111010001
11111111 1111111 111111111111