NO          ./textures/sideA.xpm
SO          ./textures/sideE.xpm
WE          ./textures/sideC.xpm
EA          ./textures/sideD.xpm

C       98,175,225
F       12,45,154


1111111111111111111111111111111111111111111
1000000000010000000000100000100010001000001
1000000000010000000000100000100010001000001
1000000000010000000000100000100010001000001
1000000000010000000000100000100010000000001
1000000000010000000000100000100010001000001
1000000000010000000000100000100010001000001
1000000000010000000000100000100010001000001
1000000000010000000000100000100010001000001
1000000000000000000000100000100000001000001
100000000001000000000000000010001000100W001
1000000000010000000000100000000010006000001
1000000000010000000000100000100010001000001
1000000000010000000000100000100010001000001
1000000000010000000000100000100010001000001
1000000000010000000000100000100010000000001
1000000000010000000000100000100010001000001
1000000000010000000000100000100010001000001   
1111111111111111111111111111111111111111111